###############################################
#                                             #
#  ###### ###### ###### ###### ###### ######  #
#  #    # #    # #    # #    # #    # #    #  #
#  #    # #    # #    # #    # #    # #    #  #
#  ### ## ### ## ### ## ### ## ### ## ### ##  #
#                                             #
#  ## ### ## ### ## ### ## ### ## ### ## ###  #
#  #    # #    # #    # #    # #    # #    #  #
#  #    # #    # #    # #    # #    # #    #  #
#  ###### ###### ###### ###### ###### ######  #
#                                             #
###############################################